# Map file for tile-based game
# (Lines that start with '#' are comments)
# The tiles are:
#   (Space) Empty tile
#   A..Z    Tiles A through Z
#   o       Star
#   !       Music Note
#   *       Goal
#   1       Bad Guy 1 (grub)
#   2       Bad Guy 2 (fly)
                                                                                                                                 EBAAAA        
                                                           o     o                          2                       2            CAAAAA
                       I  I  I  III                  o      o    o                                              o                CAAAAA
                       I  I  I   I              o     o      o               EB    BF                           o                CAAAAA
                       I  I  I   I               o     o         2          EAA    AAF           IIII      IIII o           *    CAAAAA
                                                  o        2               EAAA    AAAF    III                  o          III   CAAAAA
                                  2                 2EF                   EAAAA    AAAAF             2          o       III      CAAAAA
                 EF                                 EGD                  EAAAAA    AAAAAF                       o    III         CAAAAA
        EF  1    CD       1           1            EGAD                 EAAAAAA    AAAAAAF           1    1                      CAAAAA
BBBBBBBBGHBBBBBBBGHBBBBBBBBBBBBBBBBBBBBBBBBBBBBBBBBGAAHBBBBBBBBBBBBBBBBBAAAAAAA    AAAAAAABBBBBBBBBBBBBBBBBBBBBBBBBBBBBBBBBBBBBBBAAAAAA
